Burning the midnight oil, they call it! Midnight's a normal night for you, but this paper you've been writing for your professor has taken you many hours past that. After a miserable, exhausting night, you crawled into your bed for a few hours of rest before handing the beast in. You aren't having class today, but your professor said you should bring the paper to his office and hand it in to him by the time your class would normally begin. Morning approaches...

Paper Route
An Interactive Fiction by Paul Broyles
Release 3 / Serial number 180527 / Inform 7 build 6M62 (I6/v6.33 lib 6/12N) SD

Your dorm room (in your bed)
The ceiling of your dorm room stares down at you, as it does most mornings. Out of the corners of your eyes, you make out a sea of chaos around you. The plain, unmarked ceiling is reassuring by comparison.

>e
You would have to get out of your bed first.

>w
You would have to get out of your bed first.

>n
You would have to get out of your bed first.

>get up
You get out of your bed.

Your dorm room
Your room is a mess--hardly surprising, given the all-nighter you pulled. books and papers are strewn everywhere. In a corner by your dorm window, your desk is the epicenter of the chaos; your computer sits in a blank spot at the eye of the storm.

You can see your room door, your bed (empty) and your roommate's bed (in which is your roommate) here.

>n
(first opening your room door)

dorm hallway
The hallway runs from one end of the dorm to the other, lined with identical room doors. At one end, to the west, is the computer lab. To the east, a door leads outside. Your dorm room is to the south.

You can see your room door, a main door, the computer lab door and a door swipe box here.

>print paper
You'll have to find your paper before you can print it.

>turn on computer
It isn't something you can switch.

>look
dorm hallway
The hallway runs from one end of the dorm to the other, lined with identical room doors. At one end, to the west, is the computer lab. To the east, a door leads outside. Your dorm room is to the south.

You can see your room door, a main door, the computer lab door and a door swipe box here.

>open door
Which do you mean, your room door, the main door, the computer lab door or the door swipe box?

>lab
It seems to be locked.

>e
There's no point leaving without your paper! Your professor is quite firm about deadlines, and he's not going to take any excuses.

>w
(first opening the computer lab door)
It seems to be locked.

>s
Your dorm room
Your room is a mess--hardly surprising, given the all-nighter you pulled. books and papers are strewn everywhere. In a corner by your dorm window, your desk is the epicenter of the chaos; your computer sits in a blank spot at the eye of the storm.

You can see your room door, your bed (empty) and your roommate's bed (in which is your roommate) here.

>get id
Taken.

>search computer
You poke grumpily at some keys, but nothing happens. Oh, it's still turned off. No wonder.

>turn on computer
You switch the computer on.

>search computer
Your fingers fly across the keys as exciting music swells in the background. You are a hacker genius! Or at least you know how to work the search box. Now, to get it out of the computer...

>search for paper
You hardly know where to begin. Instead of searching for something, why not say where you want to look? Then you could start to narrow it down. For instance, you might search your bed...

>print paper
The progress bar on your computer ticks away with excruciating slowness, but at last it hits 100%. There! It's done!

You strain your ears for the whirring sounds of paper and ink nozzles. Nothing. Err...

It slowly dawns on you that you don't actually own a printer. But it's clearly printed to somewhere. If only you weren't too tired to remember where.

>n
dorm hallway
The hallway runs from one end of the dorm to the other, lined with identical room doors. At one end, to the west, is the computer lab. To the east, a door leads outside. Your dorm room is to the south.

You can see your room door, a main door, the computer lab door and a door swipe box here.

>e
There's no point leaving without your paper! Your professor is quite firm about deadlines, and he's not going to take any excuses.

* * *

>w
(first opening the computer lab door)
It seems to be locked.

>unlock door
Which do you mean, your room door, the main door, the computer lab door or the door swipe box?

>lab
(with the ID card)
That doesn't seem to fit the lock.

>i
You are carrying:
  an ID card

>look
dorm hallway
The hallway runs from one end of the dorm to the other, lined with identical room doors. At one end, to the west, is the computer lab. To the east, a door leads outside. Your dorm room is to the south.

You can see your room door, a main door, the computer lab door and a door swipe box here.

>swipe id card in box
The door to the computer lab unlocks with a click.

>e
There's no point leaving without your paper! Your professor is quite firm about deadlines, and he's not going to take any excuses.

>w
(first opening the computer lab door)

computer lab
The computer lab is full of stacks of cash--except the stacks of cash take the shape of shiny new computers. On a table near the front there's a printer with a pay box next to it. There's a stapler on the table as well. The large glass door leads back east to the main hallway.

You can see the computer lab door and a table here.

>x table
The wooden table feels incongruously low-tech in this room buzzing with computation. On top of it you can see the printer and the stapler. There's a small drawer in the center.

On the table are a printer (empty) and a stapler (empty).

>x printer
This printer is enormous! Clearly when it comes to technology, size does matter. The tray is empty.

>x stapler
It's a perfectly ordinary stapler. It seems to be empty right now.

>use printer
Actually, you can't do anything with the printer itself. You have to have a computer to print anything, and even the pay station is a separate device. Technology, huh?

>x table
The wooden table feels incongruously low-tech in this room buzzing with computation. On top of it you can see the printer and the stapler. There's a small drawer in the center.

On the table are a printer (empty) and a stapler (empty).

* * *

>get paper
You can't see any such thing.

>get up
You get out of your bed.

Your dorm room
Your room is a mess--hardly surprising, given the all-nighter you pulled. books and papers are strewn everywhere. In a corner by your dorm window, your desk is the epicenter of the chaos; your computer sits in a blank spot at the eye of the storm.

You can see your room door, your bed (empty) and your roommate's bed (in which is your roommate) here.

>get paper
That isn't available.

>x paper
You'd love to! But you'll have to find it first.

>search paper
That isn't available.

>search for paper
You'd love to! But you'll have to find it first.

>search computer for paper
You poke grumpily at some keys, but nothing happens. Oh, it's still turned off. No wonder.

>turn on computer
You switch the computer on.

>lick paper
That's not a verb I recognise.

>climb paper
That isn't available.

>search computer for paper
Your fingers fly across the keys as exciting music swells in the background. You are a hacker genius! Or at least you know how to work the search box. Now, to get it out of the computer...

* * *

>get up
You get out of your bed.

Your dorm room
Your room is a mess--hardly surprising, given the all-nighter you pulled. books and papers are strewn everywhere. To the north, your room door leads to the main hallway.

You can see your ID card half sticking out under the piles of stuff on your desk.

Your computer sits in the middle of the desk, a blank spot at the eye of the storm.

You can see your bed (empty) and your roommate's bed (in which is your roommate) here.

>get id
Taken.

>turn on computer
You switch the computer on.

>search computer
Your fingers fly across the keys as exciting music swells in the background. You found the paper! You are a hacker genius! Or at least you know how to work the search box. Now, to get it out of the computer...

>print paper
The progress bar on your computer ticks away with excruciating slowness, but at last it hits 100%. There! It's done!

You strain your ears for the whirring sounds of paper and ink nozzles. Nothing. Err...

It slowly dawns on you that you don't actually own a printer. But it's clearly printed to somewhere. If only you weren't too tired to remember where.

>n
(first opening your room door)

Dorm hallway
The hallway runs from one end of the dorm to the other, lined with identical room doors. At one end, to the west, is the computer lab. To the east, a door leads outside. Your dorm room is to the south.

You can see a lab swipe box here.

>swipe card
(in the lab swipe box)
The door to the computer lab unlocks with a click.

>w
(first opening the computer lab door)

computer lab
The computer lab is full of stacks of cash--except the stacks of cash take the shape of shiny new computers. On a table near the front there's a printer with a pay box next to it. There's a stapler on the table as well. The large glass door leads back east to the main hallway.

You can see a table here.

>swipe card
(in the pay box)
With a whirring sound, the printer roars to life and spits out a series of white pages, face down. You hardly dare to hope...

>get paper
Taken.

>e
Dorm hallway
The hallway runs from one end of the dorm to the other, lined with identical room doors. At one end, to the west, is the computer lab. To the east, a door leads outside. Your dorm room is to the south.

You can see a lab swipe box here.

>e
(first opening the main door)

Grassy area
A large grassy expanse lies in front of the dorm. A quiet footpath meanders north toward your professor's office. A street runs to the northeast.

A student lies sprawled on a blanket on the grass, studying.

You can also see a bicycle here.

You feel a sudden surge of panic. You glance at your wrist, but of course you never wear a watch. Still, you have this sudden feeling that you're running out of time. You'd better get the paper in fast!

>ask the student about the bus
"It comes every couple of minutes," she answers. "Just wait around; it'll show up."

>ask the student about bus
"It comes every couple of minutes," she answers. "Just wait around; it'll show up."

>take bus
You can't see any such thing.

>attack student
Feeling desperate and aggressive, you hurl yourself at the student, fists flying. She goes out like a light. Let's see her stop you from taking that bicycle now! But despite your bravado, your stomach twists nervously.

The bus arrives from the northeast.

>get bike
You mount the bicycle.

>ne
Road (on the bicycle)
The road through campus is lightly traficked. It bends to the northwest, and stretches behind to the southwest.

The bus goes northeast.

>nw
Office lawn (on the bicycle)
You are standing in a small grassy area in front of a white house, with a wooden front door leading in. Yes, it's an old house. It's also an office building. Just one of the oddities you might run into on a campus that's slowly eating up its town.

A graduate student sits on the grass in front of the building, his nose in a book.

The bus goes northwest.

>get off
You dismount the bicycle.

Office lawn
You are standing in a small grassy area in front of a white house, with a wooden front door leading in. Yes, it's an old house. It's also an office building. Just one of the oddities you might run into on a campus that's slowly eating up its town.

A bus from the campus transit system sits next to the curb.

A graduate student sits on the grass in front of the building, his nose in a book.

You can also see a bicycle here.

>attack student
Something inside you snaps. All of your exhaustion and frustration are too much to take, and your body fills with violent energy. You pull back your fist. The poor surprised a grad student doesn't even have time to see it coming before your hand connects with an unyielding skull.

Ouch! You're so stung by the pain searing through your hand that it's a moment before you notice that the grad student is now sprawled on the ground, unconscious. After a moment, you notice that a key has fallen out of the grad student's pocket.

The bus goes southeast.

>get key
Taken.

>n
(first opening the front door)
It seems to be locked.

>unlock door
(with the office key)
You unlock the front door.

>n
(first opening the front door)

Foyeur
Along one side of the hall is a row of mailboxes, labeled with the names of various professors. Opposite the mailboxes, you see a closed door to the west. A hall stretches on to the north.

>n
Office hall
A short hallway stretches toward the back of the building, where it ends in a small window overlooking a parking lot.

A door to the east leads to an office. It is closed.

A closed door with no nameplate is set into the west wall.

>knock
(on professor's door)
"Come in," a voice calls from within.

You can hear bells in the distance, their melodious chime floating across campus on the breeze. The deadline is here. A wave of crushing disappointment floods through you as you realize you've failed to get the paper in on time. Still, you must press on: a late penalty is better than no grade at all.

>w
(first opening unmarked door)
It seems to be locked.

>e
(first opening professor's door)

Professor's office
The professor's office seems to overflow with learning. Bookshelves line the walls, filled with tomes bearing obscure and incomprehensible titles.

A door to the east leads to an office. Inside, you can see your professor.

The professor sits behind the large desk, looking intently at a book.

>give paper to professor
(the professor)
You nervously hand over the paper. The professor glances down at the front page. "Couldn't you even bothered to staple it?" With a sigh, the paper disappears somewhere into the professor's voluminous desk.

>e
You can't go that way.

>s
You can't go that way.

>w
Office hall
A short hallway stretches toward the back of the building, where it ends in a small window overlooking a parking lot.

A door to the east leads to an office. Inside, you can see your professor.

A closed door with no nameplate is set into the west wall.

>s
Foyeur
Along one side of the hall is a row of mailboxes, labeled with the names of various professors. Opposite the mailboxes, you see a closed door to the west. A hall stretches on to the north.

>s
You leave the office and trudge back to your dorm. You arrive to find your roommate still blissfully unconscious--the lucky fool. Exhausted, you sink into your soft bed, ready to get some rest at last.

You're jerked awake a short time later by a sharp pounding at the door. Your head throbs as you stumble blearily over to open it. You feel very small next to the towering figures silhouetted against the too-bright light of the hallway. "We've got some questions for you," one of the police officers says gruffly. "About your attacks on the hard-working student and the grad student." Your stomach sinks. You're certainly not going to back to sleep now.

The process drags on over several months. In the end, you don't face criminal charges, but you're dismissed from the university, and you're working to pay a hefty financial settlement to the students you assaulted. In retrospect, failing your paper doesn't sound so bad.

Several weeks later, you finally hear about your paper. You handed it in late, so you received a penalty. You get the feeling that by the time you handed in your paper, your professor was a little annoyed with you, and it showed in the grading. In the end, after all that work, your grade on the paper is B-.

    *** YOU ARE EXPELLED ***

Would you like to RESTART, RESTORE a saved game, QUIT or UNDO the last command?

* * *

>get up
You get out of your bed.

Your dorm room
Your room is a mess--hardly surprising, given the all-nighter you pulled. books and papers are strewn everywhere. To the north, your room door leads to the main hallway.

You can see your ID card half sticking out under the piles of stuff on your desk.

Your computer sits in the middle of the desk, a blank spot at the eye of the storm.

You can see your bed (empty) and your roommate's bed (in which is your roommate) here.

>turn on computer
You switch the computer on.

* * *

>print paper
The progress bar on your computer ticks away with excruciating slowness, but at last it hits 100%. There! It's done!

You strain your ears for the whirring sounds of paper and ink nozzles. Nothing. Err...

It slowly dawns on you that you don't actually own a printer. But it's clearly printed to somewhere. If only you weren't too tired to remember where.

>get id
Taken.

>n
(first opening your room door)

Dorm hallway
The hallway runs from one end of the dorm to the other, lined with identical room doors. At one end, to the west, is the computer lab. To the east, a door leads outside. Your dorm room is to the south.

You can see a lab swipe box here.

>w
(first opening the computer lab door)
It seems to be locked.

>swipe card
(in the lab swipe box)
The door to the computer lab unlocks with a click.

* * *

>get paper
Taken.

>open drawer
You open the drawer, revealing some staples.

>put staples in stapler
(first taking the staples)
You put the staples into the stapler.

>staple paper
(with the stapler)
The stapler closes on the paper with a satisfying click. There, your pages will stay together.

>e
Dorm hallway
The hallway runs from one end of the dorm to the other, lined with identical room doors. At one end, to the west, is the computer lab. To the east, a door leads outside. Your dorm room is to the south.

You can see a lab swipe box here.

>e
(first opening the main door)

Grassy area
A large grassy expanse lies in front of the dorm. A quiet footpath meanders north toward your professor's office. A street runs to the northeast.

A bus from the campus transit system sits next to the curb.

A student lies sprawled on a blanket on the grass, studying.

You can also see a bicycle here.

You feel a sudden surge of panic. You glance at your wrist, but of course you never wear a watch. Still, you have this sudden feeling that you're running out of time. You'd better get the paper in fast!

>ask student about bike
"If it's that much of an emergency, I'd let you borrow it," she tells you. "But I'd need you to leave something important with me so I can be sure you'll bring it back."

The bus goes northeast.

>give it to student
(first taking the bicycle)
"Ahem." The student has torn herself away from her book and is glaring at you. "That's mine. You aren't stealing, are you?

>undo
Grassy area
[Previous turn undone.]

>give id to student
"Yeah, that should work," she says, smiling. "You'll have to come back if you want to eat. Okay, you can borrow my bicycle." Your ID card disappears into her pocket.

>ride bike
You mount the bicycle.

>ne
Road (on the bicycle)
The road through campus is lightly traficked. It bends to the northwest, and stretches behind to the southwest.

The bus goes southeast.

>nw
Office lawn (on the bicycle)
You are standing in a small grassy area in front of a white house, with a wooden front door leading in. Yes, it's an old house. It's also an office building. Just one of the oddities you might run into on a campus that's slowly eating up its town.

A graduate student sits on the grass in front of the building, his nose in a book.

>get off
You dismount the bicycle.

Office lawn
You are standing in a small grassy area in front of a white house, with a wooden front door leading in. Yes, it's an old house. It's also an office building. Just one of the oddities you might run into on a campus that's slowly eating up its town.

A graduate student sits on the grass in front of the building, his nose in a book.

You can also see a bicycle here.

>ask student about door
"Oh, sure, I can let you in," he says. He rises, goes over to the door, and fumbles in his pocket for a moment before producing the key with a look of triumph. "Here we go!" he exclaims, turning the key in the lock. Or trying to. It's stuck. With mounting frustration you watch as he fiddles with the knob, but finally, the door unlocks with a click. The student heaves a sigh and returns to where he was sitting before, looking forlornly at the book.

>n
(first opening the front door)

Foyeur
Along one side of the hall is a row of mailboxes, labeled with the names of various professors. Opposite the mailboxes, you see a closed door to the west. A hall stretches on to the north.

* * *

>n
Office hall
A short hallway stretches toward the back of the building, where it ends in a small window overlooking a parking lot.

A door to the east leads to an office. It is closed.

A closed door with no nameplate is set into the west wall.

>knock
(on professor's door)
"Come in," a voice calls from within.

>e
(first opening professor's door)

Professor's office
The professor's office seems to overflow with learning. Bookshelves line the walls, filled with tomes bearing obscure and incomprehensible titles.

A door to the east leads to an office. Inside, you can see your professor.

The professor sits behind the large desk, looking intently at a book.

>give paper to professor
(the professor)
You nervously hand over the paper. The professor glances down at the front page. With a sigh, the paper disappears somewhere into the professor's voluminous desk.

>e
You can't go that way.

>w
Office hall
A short hallway stretches toward the back of the building, where it ends in a small window overlooking a parking lot.

A door to the east leads to an office. Inside, you can see your professor.

A closed door with no nameplate is set into the west wall.

You can hear bells in the distance, their melodious chime floating across campus on the breeze. The deadline is here. You breathe a sigh of relief at having gotten your paper in.

>s
Foyeur
Along one side of the hall is a row of mailboxes, labeled with the names of various professors. Opposite the mailboxes, you see a closed door to the west. A hall stretches on to the north.

>s
You leave the office and trudge back to your dorm, stopping along the way to collect your ID card. You arrive to find your roommate gone, apparently having decided to go to class for once. Exhausted, you sink into your soft bed, ready to get some rest at last.

Several weeks later, you finally hear about your paper. In the end, after all that work, your grade on the paper is A.

    *** The End ***

Would you like to RESTART, RESTORE a saved game, QUIT or UNDO the last command?

* * *

>look
Your dorm room (in your bed)
The ceiling of your dorm room stares down at you, as it does most mornings. Out of the corners of your eyes, you make out a sea of chaos around you. The plain, unmarked ceiling is reassuring by comparison.

>get up
You get out of your bed.

Your dorm room
Your room is a mess--hardly surprising, given the all-nighter you pulled. books and papers are strewn everywhere. To the north, your room door leads to the main hallway.

You can see your ID card half sticking out under the piles of stuff on your desk.

Your computer sits in the middle of the desk, a blank spot at the eye of the storm.

You can see your bed (empty) and your roommate's bed (in which is your roommate) here.

* * *

>print paper
The progress bar on your computer ticks away with excruciating slowness, but at last it hits 100%. There! It's done!

You strain your ears for the whirring sounds of paper and ink nozzles. Nothing. Err...

It slowly dawns on you that you don't actually own a printer. But it's clearly printed to somewhere. If only you weren't too tired to remember where.

>e
You can't go that way.

>w
You can't go that way.

>out
But you aren't in anything at the moment.

>n
(first opening your room door)

Dorm hallway
The hallway runs from one end of the dorm to the other, lined with identical room doors. At one end, to the west, is the computer lab. To the east, a door leads outside. Your dorm room is to the south.

You can see a lab swipe box here.

>swipe id
(in the lab swipe box)
The door to the computer lab unlocks with a click.

>w
(first opening the computer lab door)

computer lab
The computer lab is full of stacks of cash--except the stacks of cash take the shape of shiny new computers. On a table near the front there's a printer with a pay box next to it. There's a stapler on the table as well. The large glass door leads back east to the main hallway.

You can see a table here.

>x stacks
Come on, don't you know what a metaphor is? Maybe they need to invest some of that technology budget in English classes.

>x cash
Come on, don't you know what a metaphor is? Maybe they need to invest some of that technology budget in English classes.

>swipe
(the ID card in the pay box)
With a whirring sound, the printer roars to life and spits out a series of white pages, face down. You hardly dare to hope...

>get paper
Taken.

* * *

>open drawer
You open the drawer, revealing some staples.

>get staples
Taken.

>put staples in stapler
You put the staples into the stapler.

>staple paper
(with the stapler)
The stapler closes on the paper with a satisfying click. There, your pages will stay together.

>look
computer lab
The computer lab is full of stacks of cash--except the stacks of cash take the shape of shiny new computers. On a table near the front there's a printer with a pay box next to it. There's a stapler on the table as well. The large glass door leads back east to the main hallway.

You can see a table here.

>e
Dorm hallway
The hallway runs from one end of the dorm to the other, lined with identical room doors. At one end, to the west, is the computer lab. To the east, a door leads outside. Your dorm room is to the south.

You can see a lab swipe box here.

>e
(first opening the main door)

Grassy area
A large grassy expanse lies in front of the dorm. A quiet footpath meanders north toward your professor's office. A street runs to the northeast.

A bus from the campus transit system sits next to the curb.

A student lies sprawled on a blanket on the grass, studying.

You can also see a bicycle here.

You feel a sudden surge of panic. You glance at your wrist, but of course you never wear a watch. Still, you have this sudden feeling that you're running out of time. You'd better get the paper in fast!

The bus goes northeast.

>get bike
"Ahem." The student has torn herself away from her book and is glaring at you. "That's mine. You aren't stealing, are you?

>ask student about bike
"If it's that much of an emergency, I'd let you borrow it," she tells you. "But I'd need you to leave something important with me so I can be sure you'll bring it back."

>give id to student
"Yeah, that should work," she says, smiling. "You'll have to come back if you want to eat. Okay, you can borrow my bicycle." Your ID card disappears into her pocket.

>ride bike
You mount the bicycle.

The bus goes southwest.

>ne
Road (on the bicycle)
The road through campus is lightly traficked. It bends to the northwest, and stretches behind to the southwest.

>nw
Office lawn (on the bicycle)
You are standing in a small grassy area in front of a white house, with a wooden front door leading in. Yes, it's an old house. It's also an office building. Just one of the oddities you might run into on a campus that's slowly eating up its town.

A graduate student sits on the grass in front of the building, his nose in a book.

>dismount
You dismount the bicycle.

Office lawn
You are standing in a small grassy area in front of a white house, with a wooden front door leading in. Yes, it's an old house. It's also an office building. Just one of the oddities you might run into on a campus that's slowly eating up its town.

A graduate student sits on the grass in front of the building, his nose in a book.

You can also see a bicycle here.

The bus arrives from the southeast.

>n
(first opening the front door)
It seems to be locked.

>ask grad student about key
"Oh, sure, I can let you in," he says. He rises, goes over to the door, and fumbles in his pocket for a moment before producing the key with a look of triumph. "Here we go!" he exclaims, turning the key in the lock. Or trying to. It's stuck. With mounting frustration you watch as he fiddles with the knob, but finally, the door unlocks with a click. The student heaves a sigh and returns to where he was sitting before, looking forlornly at the book.

The bus goes southeast.

>n
(first opening the front door)

Foyeur
Along one side of the hall is a row of mailboxes, labeled with the names of various professors. Opposite the mailboxes, you see a closed door to the west. A hall stretches on to the north.

* * *

>e
(first opening professor's door)

Professor's office
The professor's office seems to overflow with learning. Bookshelves line the walls, filled with tomes bearing obscure and incomprehensible titles.

A door to the east leads to an office. Inside, you can see your professor.

The professor sits behind the large desk, looking intently at a book.

>give paper to professor
(the professor)
You nervously hand over the paper. The professor glances down at the front page. With a sigh, the paper disappears somewhere into the professor's voluminous desk.

You can hear bells in the distance, their melodious chime floating across campus on the breeze. The deadline is here. You breathe a sigh of relief at having gotten your paper in.

>ask professor about paper
(the professor about that)
"You've already turned it in," the professor replies. "Now I've got to grade it."

>w
Office hall
A short hallway stretches toward the back of the building, where it ends in a small window overlooking a parking lot.

A door to the east leads to an office. Inside, you can see your professor.

A closed door with no nameplate is set into the west wall.

* * *

>z
Time passes.